I: phase shifting sequence i.e. fringe patterns
A: brightness (offset)
B: modulation
V: visibility (contrast)
T: number of frames
H: number of hues
D: number of dimensions
K: number of sets
N: number of shifts
Y: number of rows i.e. height [px]
X: number of columns i.e. width [px]
C: number of color channels
M: number of averaged intensity samples per fringe pattern frame
B: number of bits
P: number of pixels [px]
L: length of pattern [px]
η: coding efficiency
f: temporal frequencies
ν: spatial frequencies
λ: wavelengths of phase shifting pattern [px]
h: hues
w: weights for inverse vaiance weighting
q: quantization step size
Q: number of quantization bits
DN: digital numbers
dark: dark noise
quant: quantization noise
phot: photon noise
SQNR: signal to quantization noise ratio
TDM: temporal devision multiplexing
SDM: spatial devision multiplexing
FDM: frequency devision multiplexing(temporal)
WDM: wavelength devision multiplexing (color)
lcm: least common multiple
gcd: greatest common divisor
UMR: unambiguous measurement range [px]
uwr: unwrapping
FOV: field of view
PSA: phase shifting algorithm
PMD: phase measuring deflectometry
RCD: directional coded deflectometry (richtungskodierte Deflektometrie)
PMS: photometric stereo
TPU: temporal phase unwrapping
SPU: spatial phase unwrapping
SLM: spatial light modulator
ALM: angular light modulator
SALM: spatio-angular light modulator
MTF: modulation transfer function
MLA: micro lens array
LFD: light field display
LF: light field
DM: deflectometry
PU: phase unwrapping
CRF: camera resonse function
CoM: center of mass
FPP: fringe projection profilometry
FTP: Fourier-transform proflometry
BNFTP: background normalized Fourier-transform proflometry
SSB: single-sideband demodulation
FTF: frequency transfer function
DFP: digital fringe projection
CRA: chief ray angle
